坂本龍馬	さかもとりょうま		
フランシスコ・ザビエル	ふらんしすこざびえる		
一休さん	いっきゅうさん		
野球	やきゅう		
サッカー	さっかー		
ドッジボール	どっじぼーる		
ゲートボール	げーとぼーる		
バレーボール	ばれーぼーる		
バスケットボール	ばすけっとぼーる		
柔道	じゅうどう		
剣道	けんどう		
スキー	すきー		
スノーボード	すのーぼーど		
テニス	てにす		
卓球	たっきゅう		
バドミントン	ばどみんとん		
ボクシング	ぼくしんぐ		
水泳	すいえい		
弓道	きゅうどう		
ハンマー投げ	はんまーなげ		
槍（やり）投げ	やりなげ		
トランポリン	とらんぽりん		
ゴルフ	ごるふ		
綱引き	つなひき		
ボウリング	ぼうりんぐ		
パン食い競争	ぱんくいきょうそう		
玉入れ	たまいれ		
二人三脚	ににんさんきゃく		
ピッチャー	ぴっちゃー		
ゴールキーパー	ごーるきーぱー		
腕相撲	うでずもう		
相撲	すもう		
サーフィン	さーふぃん		
雪合戦	ゆきがっせん		
ボディビルダー	ぼでぃびるだー		
縄跳び	なわとび		
腹筋	ふっきん		
金メダル	きんめだる		
レッドカード	れっどかーど		
イエローカード	いえろーかーど		
ハードル	はーどる		
聖火リレー	せいかりれー		
ブーメラン	ぶーめらん		
川	かわ		
月	つき		
太陽	たいよう		
隕石（いんせき）	いんせき		
噴火	ふんか		
雷	かみなり		
雪	ゆき		
雨	あめ		
台風	たいふう		
かまくら	かまくら		
洞窟（どうくつ）	どうくつ		
煙	けむり		
炎/火	ほのお ・ひ		
マグマ	まぐま		
虹	にじ		
オーロラ	おーろら		
雪崩	なだれ		
キャンプ	きゃんぷ		
滝	たき		
初日の出	はつひので		
紅葉	こうよう		
つり橋	つりばし		
砂漠	さばく		
森林	しんりん		
ビーカー	びーかー		
三日月	みかづき		
プラネタリウム	ぷらねたりうむ		
満月	まんげつ		
土星	どせい		
懐中電灯	かいちゅうでんとう		
双眼鏡	そうがんきょう		
望遠鏡	ぼうえんきょう		
コンパス	こんぱす		
腕時計	うでどけい		
磁石	じしゃく		
虫眼鏡	むしめがね		
アリの巣	ありのす		
スコップ	すこっぷ		
虫取りあみ	むしとりあみ		
影	かげ		
温度計	おんどけい		
鏡	かがみ		
豆電球	まめでんきゅう		
かざぐるま	かざぐるま		
分度器	ぶんどき		
三角定規	さんかくじょうぎ		
天秤（てんびん）	てんびん		
エンピツ	えんぴつ		
消しゴム	けしごむ		
宇宙	うちゅう		
水鉄砲	みずでっぽう		
試験管	しけんかん		
つらら	つらら		
雪の結晶	ゆきのけっしょう		
ロウソク	ろうそく		
心臓	しんぞう		
胃	い		
脳	のう		
飛行機雲	ひこうきぐも		
目	め		
ウマ	うま		
ウシ	うし		
イヌ	いぬ		
ネコ	ねこ		
ハムスター	はむすたー		
ネズミ	ねずみ		
ヒツジ	ひつじ		
タコ	たこ		
カブトムシ	かぶとむし		
クワガタ	くわがた		
セミ	せみ		
トンボ	とんぼ		
ハチ	はち		
テントウムシ	てんとうむし		
アリ	あり		
ダンゴムシ	だんごむし		
ザリガニ	ざりがに		
モグラ	もぐら		
カマキリ	かまきり		
バッタ	ばった		
ハエ	はえ		
ミノムシ	みのむし		
キツネ	きつね		
クマ	くま		
カタツムリ	かたつむり		
カメムシ	かめむし		
リス	りす		
カメ	かめ		
金魚	きんぎょ		
サル	さる		
ラッコ	らっこ		
ゾウ	ぞう		
ライオン	らいおん		
アルマジロ	あるまじろ		
トラ	とら		
シマウマ	しまうま		
カモメ	かもめ		
スズメ	すずめ		
カラス	からす		
コウモリ	こうもり		
ハト	はと		
サイ	さい		
クジャク	くじゃく		
シロクマ	しろくま		
ツル	つる		
ペンギン	ぺんぎん		
ゴリラ	ごりら		
ブタ	ぶた		
ダチョウ	だちょう		
オオカミ	おおかみ		
トカゲ	とかげ		
シカ	しか		
ハリネズミ	はりねずみ		
フクロウ	ふくろう		
フラミンゴ	ふらみんご		
ウサギ	うさぎ		
ラクダ	らくだ		
ヘビ	へび		
アルパカ	あるぱか		
カンガルー	かんがるー		
コアラ	こあら		
トリケラトプス	とりけらとぷす		
ティラノサウルス	てぃらのさうるす		
プテラノドン	ぷてらのどん		
キリン	きりん		
イノシシ	いのしし		
クラゲ	くらげ		
ヒトデ	ひとで		
ホタテ	ほたて		
ピラニア	ぴらにあ		
ホタル	ほたる		
アヒル	あひる		
ハクチョウ	はくちょう		
蚊	か		
アメンボ	あめんぼ		
イモムシ	いもむし		
エイ	えい		
ウナギ	うなぎ		
ナマズ	なまず		
アンコウ	あんこう		
メダカ	めだか		
ハリセンボン	はりせんぼん		
ムササビ	むささび		
ウニ	うに		
イソギンチャク	いそぎんちゃく		
ヤドカリ	やどかり		
カニ	かに		
サソリ	さそり		
ダックスフンド	だっくすふんど		
ツバメ	つばめ		
ヒヨコ	ひよこ		
トナカイ	となかい		
ワカメ	わかめ		
シイタケ	しいたけ		
マツタケ	まつたけ		
バラ	ばら		
いちょう	いちょう		
ヤシの木	やしのき		
チューリップ	ちゅーりっぷ		
ひまわり	ひまわり		
たんぽぽ	たんぽぽ		
桜	さくら		
菊	きく		
ウメ	うめ		
ニワトリ	にわとり		
マンボウ	まんぼう		
松	まつ		
竹	たけ		
イルカ	いるか		
クジラ	くじら		
オタマジャクシ	おたまじゃくし		
ひょうたん	ひょうたん		
どんぐり	どんぐり		
ロープウェイ	ろーぷうぇい		
エレベーター	えれべーたー		
エスカレーター	えすかれーたー		
ベビーカー	べびーかー		
三輪車	さんりんしゃ		
一輪車	いちりんしゃ		
自転車	じてんしゃ		
ショベルカー	しょべるかー		
戦車	せんしゃ		
新幹線	しんかんせん		
電車	でんしゃ		
いかだ	いかだ		
ヨット	よっと		
潜水艦	せんすいかん		
飛行機	ひこうき		
気球	ききゅう		
飛行船	ひこうせん		
ヘリコプター	へりこぷたー		
スペースシャトル	すぺーすしゃとる		
竹馬	たけうま		
ローラースケート	ろーらーすけーと		
スケートボード	すけーとぼーど		
丸太	まるた		
タイムマシン	たいむましん		
救急車	きゅうきゅうしゃ		
消防車	しょうぼうしゃ		
パトカー	ぱとかー		
バス	ばす		
運動会	うんどうかい		
盆踊り	ぼんおどり		
獅子舞	ししまい		
花火大会	はなびたいかい		
初詣	はつもうで		
節分	せつぶん		
雛祭り（ひなまつり）	ひなまつり		
こいのぼり	こいのぼり		
夏休み	なつやすみ		
七夕	たなばた		
月見	つきみ		
クリスマス	くりすます		
結婚式	けっこんしき		
花見	はなみ		
バレンタインデー	ばれんたいんでー		
ハロウィン	はろうぃん		
卒業	そつぎょう		
遠足	えんそく		
年賀状	ねんがじょう		
お年玉	おとしだま		
門松	かどまつ		
肝試し	きもだめし		
読書	どくしょ		
もちつき	もちつき		
キャンプファイアー	きゃんぷふぁいあー		
宇宙飛行士	うちゅうひこうし		
占い師	うらないし		
歌手	かしゅ		
看護師	かんごし		
先生	せんせい		
軍人	ぐんじん		
警察官	けいさつかん		
芸人	げいにん		
アイドル	あいどる		
スパイ	すぱい		
サラリーマン	さらりーまん		
指揮者	しきしゃ		
カメラマン	かめらまん		
車掌	しゃしょう		
消防士	しょうぼうし		
漁師	りょうし		
大工	だいく		
探偵	たんてい		
花屋	はなや		
ダンサー	だんさー		
メイド	めいど		
コック	こっく		
小学生	しょうがくせい		
神父	しんぷ		
博士	はかせ		
バニーガール	ばにーがーる		
侍	さむらい		
忍者	にんじゃ		
サンタクロース	さんたくろーす		
すし職人	すししょくにん		
海賊	かいぞく		
ピエロ	ぴえろ		
マジシャン	まじしゃん		
木こり	きこり		
ピアニスト	ぴあにすと		
歯医者	はいしゃ		
アメリカ合衆国	あめりかがっしゅうこく		
日本	にほん		
中国	ちゅうごく		
インド	いんど		
オーストラリア	おーすとらりあ		
韓国	かんこく		
エジプト	えじぷと		
北海道	ほっかいどう		
東京都	とうきょうと		
山梨県	やまなしけん		
静岡県	しずおかけん		
京都府	きょうとふ		
奈良県	ならけん		
大阪府	おおさかふ		
沖縄県	おきなわけん		
北極	ほっきょく		
病院	びょういん		
横断歩道	おうだんほどう		
八百屋	やおや		
魚屋	さかなや		
本屋	ほんや		
美容院・床屋	びよういん ・とこや		
パン屋	ぱんや		
空港	くうこう		
踏切	ふみきり		
公園	こうえん		
噴水	ふんすい		
すべり台	すべりだい		
ジャングルジム	じゃんぐるじむ		
ペットショップ	ぺっとしょっぷ		
郵便局	ゆうびんきょく		
宝石店	ほうせきてん		
遊園地	ゆうえんち		
水族館	すいぞくかん		
映画館	えいがかん		
野球場	やきゅうじょう		
歩道橋	ほどうきょう		
お化け屋敷	おばけやしき		
ジェットコースター	じぇっとこーすたー		
観覧車	かんらんしゃ		
メリーゴーラウンド	めりーごーらうんど		
温泉	おんせん		
動物園	どうぶつえん		
メガネ屋	めがねや		
バス停	ばすてい		
テント	てんと		
郵便ポスト	ゆうびんぽすと		
サーカス	さーかす		
雪だるま	ゆきだるま		
テレビ	てれび		
目覚まし時計	めざましどけい		
ジョウロ	じょうろ		
トイレットペーパー	といれっとぺーぱー		
ゴミ箱	ごみばこ		
掃除機	そうじき		
冷蔵庫	れいぞうこ		
洗濯機	せんたくき		
ほうき	ほうき		
ちりとり	ちりとり		
パソコン	ぱそこん		
時計	とけい		
ハンガー	はんがー		
水槽	すいそう		
畳	たたみ		
ドライヤー	どらいやー		
扇風機	せんぷうき		
風呂	ふろ		
フライパン	ふらいぱん		
暖炉	だんろ		
帽子	ぼうし		
靴下	くつした		
スカート	すかーと		
ズボン	ずぼん		
靴	くつ		
オムツ	おむつ		
ふとん	ふとん		
着物	きもの		
下駄	げた		
スプーン	すぷーん		
フォーク	ふぉーく		
包丁	ほうちょう		
井戸	いど		
おしゃぶり	おしゃぶり		
電話	でんわ		
花瓶	かびん		
ハサミ	はさみ		
定規	じょうぎ		
ゲーム機	げーむき		
やかん	やかん		
エプロン	えぷろん		
ヘッドフォン	へっどふぉん		
掛け軸	かけじく		
マフラー	まふらー		
メガネ	めがね		
座布団	ざぶとん		
炊飯器	すいはんき		
電子レンジ	でんしれんじ		
絵の具	えのぐ		
クレヨン	くれよん		
ランドセル	らんどせる		
体重計	たいじゅうけい		
ウェディングドレス	うぇでぃんぐどれす		
アイロン	あいろん		
こたつ	こたつ		
電卓	でんたく		
うちわ	うちわ		
トランプ	とらんぷ		
スマートフォン	すまーとふぉん		
ダイヤモンド	だいやもんど		
バイオリン	ばいおりん		
ピアノ	ぴあの		
ギター	ぎたー		
トランペット	とらんぺっと		
ダルマ	だるま		
地球儀	ちきゅうぎ		
あやとり	あやとり		
太鼓	たいこ		
化粧	けしょう		
東京タワー	とうきょうたわー		
奈良の大仏	ならのだいぶつ		
金閣寺	きんかくじ		
自由の女神	じゆうのめがみ		
ナスカの地上絵	なすかのちじょうえ		
モアイ	もあい		
ピラミッド	ぴらみっど		
ラーメン	らーめん		
トマト	とまと		
にんじん	にんじん		
きゅうり	きゅうり		
ピーマン	ぴーまん		
とうがらし	とうがらし		
ニンニク	にんにく		
スイカ	すいか		
メロン	めろん		
イチゴ	いちご		
パイナップル	ぱいなっぷる		
バナナ	ばなな		
リンゴ	りんご		
さくらんぼ	さくらんぼ		
ぶどう	ぶどう		
桃	もも		
みかん	みかん		
レモン	れもん		
栗（くり）	くり		
ナシ	なし		
豆	まめ		
かぼちゃ	かぼちゃ		
きのこ	きのこ		
さつまいも	さつまいも		
たけのこ	たけのこ		
大根	だいこん		
とうもろこし	とうもろこし		
ナス	なす		
ネギ	ねぎ		
れんこん	れんこん		
ハンバーグ	はんばーぐ		
ドーナツ	どーなつ		
煎餅	せんべい		
チョコレート	ちょこれーと		
飴（あめ）	あめ		
たこ焼き	たこやき		
イカ焼き	いかやき		
納豆	なっとう		
オムライス	おむらいす		
ソフトクリーム	そふとくりーむ		
だんご	だんご		
かき氷	かきごおり		
たい焼き	たいやき		
ホットドッグ	ほっとどっぐ		
たこさんウインナー	たこさんういんなー		
目玉焼き	めだまやき		
ハンバーガー	はんばーがー		
サンドウィッチ	さんどうぃっち		
ピザ	ぴざ		
餃子（ぎょうざ）	ぎょうざ		
シュウマイ	しゅうまい		
ステーキ	すてーき		
おにぎり	おにぎり		
マヨネーズ	まよねーず		
焼き鳥	やきとり		
鍋	なべ		
かまぼこ	かまぼこ		
缶詰	かんづめ		
プリン	ぷりん		
ピーナッツ	ぴーなっつ		
ビール	びーる		
コーヒー	こーひー		
桃太郎	ももたろう		
浦島太郎	うらしまたろう		
金太郎	きんたろう		
一寸法師（いっすんぼうし）	いっすんぼうし		
白雪姫	しらゆきひめ		
シンデレラ	しんでれら		
花さかじいさん	はなさかじいさん		
さるかに合戦	さるかにがっせん		
鶴の恩返し	つるのおんがえし		
笠地蔵（かさじぞう）	かさじぞう		
おむすびころりん	おむすびころりん		
かちかち山	かちかちやま		
赤ずきん	あかずきん		
ウサギとカメ	うさぎとかめ		
裸の王様	はだかのおうさま		
三匹のこぶた	さんびきのこぶた		
みにくいアヒルの子	みにくいあひるのこ		
人魚姫	にんぎょひめ		
マッチ売りの少女	まっちうりのしょうじょ		
あしながおじさん	あしながおじさん		
ジャックと豆の木	じゃっくとまめのき		
鬼	おに		
七人の小人	しちにんのこびと		
孫悟空	そんごくう		
天使	てんし		
悪魔	あくま		
天狗（てんぐ）	てんぐ		
ドラキュラ	どらきゅら		
死神	しにがみ		
魔女	まじょ		
ヤマタノオロチ	やまたのおろち		
かぐや姫	かぐやひめ		
ドラゴン	どらごん		
雪女	ゆきおんな		
ろくろ首	ろくろくび		
河童（かっぱ）	かっぱ		
あいあい傘	あいあいがさ		
ネコ耳	ねこみみ		
妹	いもうと		
ポニーテール	ぽにーてーる		
スキップ	すきっぷ		
たこあげ	たこあげ		
羽根つき	はねつき		
バードウォッチング	ばーどうぉっちんぐ		
書道	しょどう		
犬も歩けば棒に当たる	いぬもあるけばぼうにあたる		
豚に真珠	ぶたにしんじゅ		
猫に小判	ねこにこばん		
猿も木から落ちる	さるもきからおちる		
石の上にも3年	いしのうえにもさんねん		
鬼に金棒	おににかなぼう		
まくら投げ	まくらなげ		
埴輪（はにわ）	はにわ		
笑顔	えがお		
イケメン	いけめん		
かくれんぼ	かくれんぼ		
金魚すくい	きんぎょすくい		
射的	しゃてき		
ロボット	ろぼっと		
体操服	たいそうふく		
スクール水着	すくーるみずぎ		
UFO（未確認飛行物体）	ゆーふぉー		
みつあみ	みつあみ		
幽霊	ゆうれい		
医師	いし		
お面	おめん		
うさ耳	うさみみ		
おかっぱ	おかっぱ		
チョップ	ちょっぷ		
牛乳	ぎゅうにゅう		
新聞	しんぶん		
回転ずし	かいてんずし		
ホッチキス	ほっちきす		
老人ホーム	ろうじんほーむ		
厚底靴	あつぞこぐつ		
筆箱	ふでばこ		
ゆでたまご	ゆでたまご		
妖怪	ようかい		
軍手	ぐんて		
ピコピコハンマー	ぴこぴこはんまー		
輪ゴム	わごむ		
チーズ	ちーず		
懐中時計	かいちゅうどけい		
手裏剣	しゅりけん		
魂（たましい）	たましい		
影絵	かげえ		
木魚	もくぎょ		
ヌンチャク	ぬんちゃく		
ムチ	むち		
フンドシ	ふんどし		
かかし	かかし		
福笑い	ふくわらい		
体育座り	たいいくずわり		
前へならえ	まえへならえ		
わんこそば	わんこそば		
キター！	きたー		
運命の赤い糸	うんめいのあかいいと		
ノートパソコン	のーとぱそこん		
蚊取り線香	かとりせんこう		
釘（くぎ）	くぎ		
信号機	しんごうき		
指輪	ゆびわ		
風船	ふうせん		
ピアス	ぴあす		
サボテン	さぼてん		
ゾンビ	ぞんび		
ラムネ	らむね		
香水	こうすい		
ねぐせ	ねぐせ		
ルーレット	るーれっと		
ネックレス	ねっくれす		
缶けり	かんけり		
寝言	ねごと		
大爆発	だいばくはつ		
念力	ねんりき		
にらめっこ	にらめっこ		
電車ごっこ	でんしゃごっこ		
スーパーボール	すーぱーぼーる		
バーベル	ばーべる		
ダーツ	だーつ		
盆栽	ぼんさい		
三毛猫	みけねこ		
土管	どかん		
麦わらぼうし	むぎわらぼうし		
タンクトップ	たんくとっぷ		
チェーンソー	ちぇーんそー		
非常口	ひじょうぐち		
白衣	はくい		
タートルネック	たーとるねっく		
貯金箱	ちょきんばこ		
タンバリン	たんばりん		
和太鼓	わだいこ		
カップラーメン	かっぷらーめん		
卵かけご飯	たまごかけごはん		
駄菓子	だがし		
ハチミツ	はちみつ		
トマトジュース	とまとじゅーす		
宇宙人	うちゅうじん		
もぐらたたき	もぐらたたき		
分身の術	ぶんしんのじゅつ		
内股	うちまた		
メガネ男子	めがねだんし		
やえ歯	やえば		
ウィルス	ういるす		
いびき	いびき		
アイシャドウ	あいしゃどう		
あっかんべー	あっかんべー		
痛車	いたしゃ		
肩たたき	かたたたき		
ガチャガチャ	がちゃがちゃ		
カツラ	かつら		
二刀流	にとうりゅう		
焼け石に水	やけいしにみず		
井の中の蛙大海を知らず	いのなかのかわずたいかいをしらず		
馬の耳に念仏	うまのみみにねんぶつ		
一富士二鷹三茄子	いちふじにたかさんなすび		
どんぐりの背比べ	どんぐりのせいくらべ		
地震、雷、火事、おやじ	じしんかみなりかじおやじ		
耳にタコができる	みみにたこができる		
花より団子	はなよりだんご		
双子（ふたご）	ふたご		
パイ投げ	ぱいなげ		
ネッシー	ねっしー		
おみくじ	おみくじ		
絵馬	えま		
正座	せいざ		
あくび	あくび		
背比べ	せいくらべ		
座禅	ざぜん		
キス	きす		
口紅	くちべに		
マニキュア	まにきゅあ		
ダイエット	だいえっと		
輪投げ	わなげ		
4コママンガ	よんこままんが		
手相	てそう		
鬼ごっこ	おにごっこ		
ぺろぺろキャンディ	ぺろぺろきゃんでぃ		
森のくまさん	もりのくまさん		
大きな古時計	おおきなふるどけい		
ねこふんじゃった	ねこふんじゃった		
スライム	すらいむ		
へのへのもへじ	へのへのもへじ		
眼帯	がんたい		
落とし穴	おとしあな		
キツツキ	きつつき		
ドラ焼き	どらやき		
びっくり箱	びっくりばこ		
デート	でーと		
いちごショートケーキ	いちごしょーとけーき		
ちくわ	ちくわ		
ノリ	のり		
わたあめ	わたあめ		
ざるそば	ざるそば		
冷ややっこ	ひややっこ		
カレーライス	かれーらいす		
えだまめ	えだまめ		
みつば	みつば		
ミニトマト	みにとまと		
たまねぎ	たまねぎ		
通訳	つうやく		
砲丸投げ	ほうがんなげ		
リレー	りれー		
フラフープ	ふらふーぷ		
前転	ぜんてん		
大縄跳び	おおなわとび		
スケート	すけーと		
重量挙げ	じゅうりょうあげ		
自動車（車）	じどうしゃ		
ばばぬき	ばばぬき		
おひなさま	おひなさま		
ニュースキャスター	にゅーすきゃすたー		
おでん	おでん		
人魚	にんぎょ		
エンジン	えんじん		
いくら	いくら		
からくり人形	からくりにんぎょう		
はちまき	はちまき		
くす玉	くすだま		
恵方まき	えほうまき		
ウエディングケーキ	うえでぃんぐけーき		
祭り	まつり		
汗	あせ		
秋	あき		
五目並べ	ごもくならべ		
嵐	あらし		
あんぱん	あんぱん		
絵日記	えにっき		
王冠	おうかん		
リバーシ	りばーし		
おてだま	おてだま		
口笛	くちぶえ		
クリスマスプレゼント	くりすますぷれぜんと		
お酒	おさけ		
サファリパーク	さふぁりぱーく		
白髪	しらが		
卒業	そつぎょう		
地球	ちきゅう		
地底人	ちていじん		
地平線	ちへいせん		
つむじ	つむじ		
トイレ	といれ		
晴れ	はれ		
光	ひかり		
日の出	ひので		
姫	ひめ		
吹き矢	ふきや		
へそ	へそ		
変化球	へんかきゅう		
骨	ほね		
未来	みらい		
前髪	まえがみ		
魔王	まおう		
招き猫	まねきねこ		
眉毛	まゆげ		
虫歯	むしば		
野菜	やさい		
屋根	やね		
弓	ゆみ		
夢	ゆめ		
夜桜	よざくら		
ルアー	るあー		
露天風呂	ろてんぶろ		
リコーダー	りこーだー		
安全ピン	あんぜんぴん		
CD	しーでぃー		
鉛筆削り	えんぴつけずり		
歯みがき粉	はみがきこ		
霧吹き	きりふき		
ルビー	るびー		
ロミオとジュリエット	ろみおとじゅりえっと		
ワニ	わに		
九官鳥	きゅうかんちょう		
ふんころがし	ふんころがし		
ありの行列	ありのぎょうれつ		
サメ	さめ		
蜘蛛（くも）の巣	くものす		
ミツバチ	みつばち		
パンダ	ぱんだ		
トビウオ	とびうお		
エビ	えび		
ウミガメ	うみがめ		
ふぐ	ふぐ		
ホタルイカ	ほたるいか		
ちんあなご	ちんあなご		
黒猫	くろねこ		
カエル	かえる		
花火	はなび		
ハッピーバースデイ	はっぴーばーすでい		
カンニング	かんにんぐ		
シャボン玉	しゃぼんだま		
友情	ゆうじょう		
演歌	えんか		
アニメ	あにめ		
顔文字	かおもじ		
ダジャレ	だじゃれ		
平和	へいわ		
音楽	おんがく		
言葉	ことば		
大砲	たいほう		
寝顔	ねがお		
ドラム缶	どらむかん		
ちょうちょ結び	ちょうちょむすび		
吹き出し	ふきだし		
東京スカイツリー	とうきょうすかいつりー		
イースター島	いーすたーとう		
おばあちゃん	おばあちゃん		
おじいちゃん	おじいちゃん		
無敵	むてき		
オヤジ	おやじ		
てるてるぼうず	てるてるぼうず		
汗っかき	あせっかき		
ぬりかべ	ぬりかべ		
もち	もち		
エクレア	えくれあ		
抹茶	まっちゃ		
お寿司	おすし		
魚	さかな		
肉	にく		
なめこ	なめこ		
ポテトチップス	ぽてとちっぷす		
水	みず		
キャンディー	きゃんでぃー		
アイス	あいす		
コーラ	こーら		
いちご牛乳	いちごぎゅうにゅう		
コーヒー牛乳	こーひーぎゅうにゅう		
フルーツ牛乳	ふるーつぎゅうにゅう		
チーズフォンデュ	ちーずふぉんでゅ		
メロンパン	めろんぱん		
電気	でんき		
手	て		
脱皮	だっぴ		
心霊写真	しんれいしゃしん		
親指	おやゆび		
花畑	はなばたけ		
たつまき	たつまき		
桜吹雪	さくらふぶき		
冬眠	とうみん		
ハート	はーと		
花粉症	かふんしょう		
流れ星	ながれぼし		
春	はる		
夏	なつ		
冬	ふゆ		
梅雨	つゆ		
星	ほし		
ゴミ拾い	ごみひろい		
ピカソ	ぴかそ		
地図	ちず		
逆立ち	さかだち		
跳び箱	とびばこ		
ダンス	だんす		
スイカ割り	すいかわり		
おたま	おたま		
しゃもじ	しゃもじ		
まくら	まくら		
箸（はし）	はし		
ぬいぐるみ	ぬいぐるみ		
ストロー	すとろー		
カッター	かったー		
ボールペン	ぼーるぺん		
タイヤ	たいや		
ブルマ	ぶるま		
おもちゃ	おもちゃ		
印鑑	いんかん		
こけし	こけし		
万華鏡	まんげきょう		
ドリル	どりる		
マラカス	まらかす		
鎧（よろい）	よろい		
コンタクトレンズ	こんたくとれんず		
トロフィー	とろふぃー		
太刀	たち		
ロープ	ろーぷ		
寝袋	ねぶくろ		
トランシーバー	とらんしーばー		
こま	こま		
けん玉	けんだま		
ばんそうこう	ばんそうこう		
クッション	くっしょん		
サングラス	さんぐらす		
注射	ちゅうしゃ		
電池	でんち		
ビーチパラソル	びーちぱらそる		
うきわ	うきわ		
グローブ	ぐろーぶ		
手紙	てがみ		
水着	みずぎ		
上履き	うわばき		
つまようじ	つまようじ		
メモ帳	めもちょう		
携帯電話	けいたいでんわ		
めん棒	めんぼう		
水筒	すいとう		
机（つくえ）	つくえ		
イス	いす		
コップ	こっぷ		
本	ほん		
かさ	かさ		
リボン	りぼん		
スリッパ	すりっぱ		
シャープペンシル	しゃーぷぺんしる		
ドア	どあ		
ペンチ（工具）	ぺんち		
モップ	もっぷ		
セロハンテープ	せろはんてーぷ		
コンセント	こんせんと		
リストバンド	りすとばんど		
のこぎり	のこぎり		
海	うみ		
南極	なんきょく		
富士山	ふじさん		
幽霊船	ゆうれいせん		
煙突	えんとつ		
マンホール	まんほーる		
教会	きょうかい		
看板	かんばん		
線路	せんろ		
クレーンゲーム	くれーんげーむ		
鳥居	とりい		
橋	はし		
鉄棒	てつぼう		
家	いえ		
学校	がっこう		
恐竜博物館	きょうりゅうはくぶつかん		
幼稚園	ようちえん		
小学校	しょうがっこう		
ハチ公	はちこう		
聖書	せいしょ		
禁煙	きんえん		
土下座	どげざ		
刑務所	けいむしょ		
ベーゴマ	べーごま		
釣り竿	つりざお		
バット	ばっと		
指相撲	ゆびずもう		
尻相撲	しりずもう		
ドリブル	どりぶる		
ヨーヨー	よーよー		
木登り	きのぼり		
大玉ころがし	おおだまころがし		
キャッチボール	きゃっちぼーる		
クロール	くろーる		
バタフライ（水泳）	ばたふらい		
平泳ぎ	ひらおよぎ		
背泳ぎ	せおよぎ		
頭突き	ずつき		
超音波	ちょうおんぱ		
冷房	れいぼう		
人間	にんげん		
グリーンピース	ぐりーんぴーす		
ハバネロ	はばねろ		
マッシュルーム	まっしゅるーむ		
松ぼっくり	まつぼっくり		
シートベルト	しーとべると		
優先席	ゆうせんせき		
大漁	たいりょう		
皿	さら		
母	はは		
父	ちち		
兄弟	きょうだい		
姉妹	しまい		
シャワー	しゃわー		
乾杯	かんぱい		
白旗	しろはた		
クラッカー	くらっかー		
猫舌	ねこじた		
サンバイザー	さんばいざー		
プロペラ	ぷろぺら		
つるはし	つるはし		
バール（工具）	ばーる		
折り紙	おりがみ		
紙風船	かみふうせん		
お賽銭（さいせん）	おさいせん		
ダンボール	だんぼーる		
切符	きっぷ		
鎌（かま）	かま		
泣きホクロ	なきほくろ		
ガスマスク	がすますく		
釘バット	くぎばっと		
鈴	すず		
線香	せんこう		
コントローラー	こんとろーらー		
アイマスク	あいますく		
鍵（かぎ）	かぎ		
真珠	しんじゅ		
おなら	おなら		
USBメモリ	ゆーえすびーめもり		
はなちょうちん	はなちょうちん		
ベルト	べると		
サイコロ	さいころ		
積み木	つみき		
睫毛（まつげ）	まつげ		
結婚指輪	けっこんゆびわ		
ちょんまげ	ちょんまげ		
海水浴	かいすいよく		
きしめん	きしめん		
豚足（とんそく）	とんそく		
マカロニ	まかろに		
オリーブオイル	おりーぶおいる		
ウィンナーコーヒー	うぃんなーこーひー		
エビフライ	えびふらい		
お茶漬け	おちゃづけ		
オムレツ	おむれつ		
温泉卵	おんせんたまご		
青鬼	あおおに		
赤鬼	あかおに		
怪獣	かいじゅう		
透明人間	とうめいにんげん		
バルーンアート	ばるーんあーと		
竹とんぼ	たけとんぼ		
線香花火	せんこうはなび		
知恵の輪	ちえのわ		
筆	ふで		
羽根ペン	はねぺん		
紙	かみ		
手帳	てちょう		
画鋲（がびょう）	がびょう		
バケツ	ばけつ		
歯ブラシ	はぶらし		
割り箸	わりばし		
ナイフ	ないふ		
スワンボート	すわんぼーと		
ロケット	ろけっと		
今川焼き	いまがわやき		
かりんとう	かりんとう		
きびだんご	きびだんご		
くさや	くさや		
毛蟹	けがに		
ケチャップ	けちゃっぷ		
醤油（しょうゆ）	しょうゆ		
食パン	しょくぱん		
チョココロネ	ちょこころね		
つくし	つくし		
闇	やみ		
歯車	はぐるま		
マスク	ますく		
爪	つめ		
城	しろ		
虫刺され	むしさされ		
ねこじゃらし	ねこじゃらし		
パズル	ぱずる		
拳銃	けんじゅう		
雲	くも		
駄菓子屋	だがしや		
自動ドア	じどうどあ		
防災頭巾	ぼうさいずきん		
愛	あい		
赤ちゃん	あかちゃん		
二重まぶた	ふたえまぶた		
にこにこマーク	にこにこまーく		
イヤホン	いやほん		
ペアルック	ぺあるっく		
紙飛行機	かみひこうき		
ジャンプ	じゃんぷ		
ライター	らいたー		
クローン	くろーん		
鼻毛	はなげ		
サーフボード	さーふぼーど		
スティックのり	すてぃっくのり		
カラーコンタクト	からーこんたくと		
蝶ネクタイ	ちょうねくたい		
中華鍋	ちゅうかなべ		
ツチノコ	つちのこ		
みかん箱	みかんばこ		
音符	おんぷ		
ハワイ	はわい		
洗濯バサミ	せんたくばさみ		
トライアングル	とらいあんぐる		
涙	なみだ		
ミサイル	みさいる		
風鈴	ふうりん		
チョコバナナ	ちょこばなな		
猫カフェ	ねこかふぇ		
スカンク	すかんく		
オウムガイ	おうむがい		
角	つの		
尻尾	しっぽ		
ミミズ	みみず		
セミの抜け殻	せみのぬけがら		
歯磨き	はみがき		
ラブレター	らぶれたー		
矢文	やぶみ		
ホイッスル	ほいっする		
金魚鉢	きんぎょばち		
石鹸	せっけん		
振り子	ふりこ		
バネ	ばね		
鉄パイプ	てつぱいぷ		
消火器	しょうかき		
拡声器	かくせいき		
目隠し	めかくし		
踏み絵	ふみえ		
舌	した		
唇	くちびる		
髭（ひげ）	ひげ		
くない	くない		
火炎放射器	かえんほうしゃき		
ミキサー車	みきさーしゃ		
スプーン曲げ	すぷーんまげ		
人生	じんせい		
ミニスカート	みにすかーと		
スキンヘッド	すきんへっど		
リーゼント	りーぜんと		
アフロヘアー	あふろへあー		
カスタネット	かすたねっと		
ミイラ	みいら		
のっぺらぼう	のっぺらぼう		
両手に花	りょうてにはな		
ふりかけ	ふりかけ		
お菓子の家	おかしのいえ		
肉球	にくきゅう		
くしゃみ	くしゃみ		
デコピン	でこぴん		
ドミノ倒し	どみのたおし		
双葉（ふたば）	ふたば		
電波	でんぱ		
ハエタタキ	はえたたき		
檻（おり）	おり		
青りんご	あおりんご		
たらこ	たらこ		
ガム	がむ		
首輪	くびわ		
マッチ棒	まっちぼう		
ラバーカップ	らばーかっぷ		
耳栓	みみせん		
松明（たいまつ）	たいまつ		
提灯（ちょうちん）	ちょうちん		
手錠	てじょう		
ラジオ	らじお		
糸電話	いとでんわ		
火吹き	ひふき		
ビー玉	びーだま		
鼻眼鏡	はなめがね		
安心	あんしん		
肩	かた		
風邪	かぜ		
タクシー	たくしー		
足跡	あしあと		
トンネル	とんねる		
迷路	めいろ		
墓地	ぼち		
ルーズソックス	るーずそっくす		
ハイヒール	はいひーる		
金髪	きんぱつ		
茶髪	ちゃぱつ		
シンバル	しんばる		
自画像	じがぞう		
人形	にんぎょう		
カメラ	かめら		
金平糖（こんぺいとう）	こんぺいとう		
急須（きゅうす）	きゅうす		
おちょこ	おちょこ		
盃（さかずき）	さかずき		
砂時計	すなどけい		
指パッチン	ゆびぱっちん		
喉仏（のどぼとけ）	のどぼとけ		
人工呼吸	じんこうこきゅう		
心臓マッサージ	しんぞうまっさーじ		
竹刀	しない		
銅鑼（どら）	どら		
ピノッキオ	ぴのっきお		
絵本	えほん		
うんてい	うんてい		
財布	さいふ		
スタンプリレー	すたんぷりれー		
勾玉	まがたま		
街灯	がいとう		
インターホン	いんたーほん		
武器	ぶき		
足かせ	あしかせ		
アウトドア	あうとどあ		
ヒッチハイク	ひっちはいく		
わかめご飯	わかめごはん		
草	くさ		
女王アリ	じょおうあり		
映画	えいが		
カバン	かばん
